성명,국어,수학,영어,총점,평균
황지영,92,49,40,181,60.33
도옥,67,88,71,226,75.33
주약란,95,100,98,293,97.67
조소접,36,15,97,148,49.33
왕산악,27,9,38,74,24.67
양몽환,7,28,65,100,33.33
동숙정,79,39,24,142,47.33
심하림,90,40,63,193,64.33
문공태,40,82,29,151,50.33
도일강,43,63,29,135,45
마가굉,62,93,93,248,82.67
운중안,10,82,86,178,59.33
신원통,95,90,89,274,91.33
이창란,35,47,26,108,36
이요홍,22,4,87,113,37.67
